12 10 10 10 10 10 10 10 10 10 10 10 10 10 10 10 10 10 10 10 10 10 10 10 10 10 13 3 3 3 3 3 3 3 3 12 10 10 10 10 10 10 10 10 10 10 10 10 10 10 10 10 10 10 10 10 10 10 10 10 10 10 10 10 13 
8 2 2 2 2 2 2 2 1 1 2 2 2 2 2 2 2 2 2 2 2 2 2 2 2 2 7 3 3 3 3 3 3 3 3 8 2 2 2 2 2 2 2 2 2 2 2 2 2 2 2 2 2 2 2 2 2 2 2 2 2 2 2 2 7 
8 2 2 2 2 2 1 1 2 2 2 2 2 2 1 2 2 2 2 2 2 2 2 2 1 1 7 3 3 3 3 3 3 3 3 8 2 1 1 1 2 2 1 2 2 2 2 2 2 2 2 2 2 2 2 2 1 2 1 1 2 2 2 2 7 
8 2 2 2 2 2 2 2 2 2 2 2 2 2 2 1 2 2 1 2 1 2 2 2 2 2 7 3 3 3 3 3 3 3 3 8 2 2 2 2 2 1 2 2 2 2 1 2 2 1 2 2 2 2 2 2 2 2 2 2 2 2 1 1 7 
8 2 2 2 1 2 2 2 2 2 2 2 2 2 2 2 2 2 2 2 2 1 1 2 2 2 7 3 3 3 3 3 3 3 3 8 2 2 2 2 1 2 2 2 1 2 2 2 2 2 1 1 2 2 2 2 2 2 2 2 2 2 2 2 7 
8 2 2 1 2 2 2 2 2 2 2 2 2 2 2 2 2 2 2 2 2 2 2 2 2 2 7 3 3 12 10 10 13 3 3 8 2 2 2 1 2 2 2 1 2 2 1 2 2 2 2 1 2 2 2 2 2 2 2 2 2 1 2 2 7 
8 2 1 2 2 2 2 2 1 1 2 1 2 1 2 2 2 2 2 2 2 2 1 1 2 2 7 3 3 8 2 2 7 3 3 8 2 2 2 2 2 2 2 2 2 2 1 2 2 2 2 2 2 2 2 2 2 2 1 2 2 2 2 2 7 
8 2 2 2 2 2 1 2 2 2 2 2 2 1 2 1 2 2 2 2 2 1 2 2 2 2 9 10 10 11 2 2 9 10 10 11 2 2 1 2 2 1 2 2 2 2 1 2 2 2 2 2 1 2 1 2 2 2 2 2 1 2 2 2 7 
8 2 2 2 2 1 2 2 2 2 2 2 2 2 2 1 2 2 2 1 2 2 2 2 2 2 2 2 1 2 36 36 2 1 1 2 2 2 1 2 2 2 2 2 2 2 2 2 2 2 2 2 1 2 2 2 2 2 2 1 2 2 2 2 7 
8 2 2 2 2 2 2 2 2 2 2 2 2 2 2 2 2 2 2 2 2 2 2 2 2 2 2 2 2 36 36 36 36 2 2 2 2 2 2 2 2 2 2 2 2 2 2 2 2 2 2 2 2 2 2 2 2 2 2 2 2 2 2 2 7 
8 2 2 2 2 2 2 2 2 2 2 2 2 2 2 2 2 2 2 2 2 2 2 2 2 2 2 2 2 2 18 2 2 2 2 2 2 2 2 2 2 1 2 2 2 2 2 2 2 2 2 2 2 2 2 1 2 2 2 2 2 2 2 2 7 
8 2 2 2 2 2 2 2 1 1 2 1 1 2 2 1 2 2 1 1 1 2 2 2 2 2 1 2 2 2 16 2 1 1 2 2 2 2 2 2 2 1 2 2 1 2 2 2 2 2 1 2 1 2 2 2 2 1 1 2 2 1 2 2 7 
8 2 2 1 2 2 2 2 2 2 2 2 1 2 2 1 2 2 2 2 1 2 2 2 2 1 2 2 2 2 18 2 2 1 2 1 2 2 2 1 1 2 2 2 2 2 1 2 2 1 2 1 2 2 2 2 2 2 2 1 2 2 2 2 7 
8 1 2 2 1 1 2 2 2 2 2 2 2 2 1 2 2 2 2 2 2 2 2 2 2 2 2 2 2 2 16 2 2 1 2 2 1 2 2 2 2 2 2 1 2 2 1 2 2 2 2 2 2 2 2 2 2 2 2 2 2 2 2 2 7 
8 1 2 2 2 1 2 2 1 2 2 2 2 2 1 2 2 1 1 2 2 2 1 2 2 2 2 2 2 2 18 2 2 2 2 2 2 2 2 2 2 2 2 1 2 2 2 2 2 1 2 2 2 2 2 2 2 2 2 1 2 2 2 2 7 
8 1 2 2 2 2 2 2 2 2 2 2 2 2 2 2 2 2 2 2 2 2 1 2 2 2 2 2 2 2 16 2 2 2 2 2 2 2 2 2 2 2 2 2 2 2 2 2 2 2 2 2 2 2 2 1 2 2 1 2 2 2 2 2 7 
8 2 2 2 2 2 2 2 2 2 2 2 2 2 2 2 2 2 2 2 2 1 2 2 2 2 2 1 2 2 18 2 1 1 1 2 2 2 2 2 1 1 2 1 2 2 1 1 2 2 2 2 2 1 2 2 2 2 2 2 2 2 2 2 7 
8 2 2 1 2 2 2 2 2 1 1 2 1 1 1 2 2 1 2 2 2 2 2 2 2 1 1 2 2 2 16 2 2 2 2 2 2 2 1 1 2 2 2 2 2 2 2 2 2 2 2 2 1 2 2 1 2 2 2 2 2 1 2 2 7 
8 2 2 1 2 2 2 2 2 2 2 2 2 2 2 2 2 2 1 2 2 2 1 2 2 2 2 2 2 2 18 2 2 1 2 2 2 2 2 1 2 2 2 2 1 2 2 2 2 2 2 2 2 2 2 2 2 2 2 2 2 1 1 1 7 
8 2 40 19 17 30 17 19 17 30 17 19 17 30 17 19 38 2 2 2 2 2 2 1 2 2 2 2 2 1 16 2 2 1 2 2 2 1 2 41 41 41 41 41 2 2 2 2 2 41 41 41 41 41 2 2 2 2 2 2 2 2 2 2 7 
8 1 41 41 41 16 41 41 41 16 41 41 41 16 41 41 41 2 2 2 2 2 2 2 2 2 2 2 1 2 18 2 2 2 2 2 2 2 2 41 41 41 41 41 2 2 1 2 2 41 41 41 41 41 1 2 2 2 1 2 2 2 2 2 7 
8 1 41 41 41 18 41 41 41 18 41 41 41 18 41 41 41 2 2 2 2 1 1 2 2 2 2 1 2 2 16 2 2 2 1 2 2 2 2 41 41 41 41 41 2 2 2 1 2 41 41 41 41 41 2 1 2 2 2 2 2 2 2 2 7 
8 2 41 41 41 16 41 41 41 16 41 41 41 16 41 41 41 2 2 2 2 2 2 2 2 2 2 2 2 2 20 2 2 2 2 1 2 2 2 2 2 18 2 2 2 2 2 2 2 2 2 18 2 2 2 1 2 2 2 2 2 1 2 2 7 
8 2 40 29 17 31 17 29 17 31 17 29 17 31 17 29 17 19 17 19 17 19 17 19 17 19 17 19 17 25 31 26 17 19 17 19 17 19 17 19 17 29 17 19 17 19 17 19 17 19 17 29 17 19 17 19 17 38 2 2 2 1 2 2 7 
8 1 41 41 41 16 41 41 41 18 41 41 41 16 41 41 41 2 2 2 2 2 2 2 2 1 1 2 2 2 24 2 2 2 1 1 1 2 2 2 2 1 2 2 2 2 2 2 2 2 2 2 2 2 2 2 1 2 2 2 2 1 2 2 7 
8 2 41 41 41 18 41 41 41 18 41 41 41 18 41 41 41 2 2 2 2 2 1 1 2 1 2 1 1 2 16 2 2 2 2 2 2 2 2 2 2 2 2 2 2 2 2 2 2 2 1 2 2 2 2 2 2 2 1 1 2 2 2 2 7 
8 2 41 41 41 16 41 41 41 18 41 41 41 16 41 41 41 2 1 2 1 1 2 2 2 2 2 2 2 2 18 2 1 2 2 2 1 1 2 2 1 2 2 2 2 1 2 2 2 2 2 1 2 1 2 2 2 2 2 1 2 2 2 2 7 
8 2 40 29 17 31 17 29 17 31 17 29 17 31 17 29 38 2 1 2 2 2 2 2 2 2 2 1 2 2 16 2 2 2 2 2 2 2 1 1 2 2 2 2 1 2 2 2 1 2 2 2 2 2 2 2 1 2 2 2 2 2 2 2 7 
8 2 41 41 41 16 41 41 41 16 41 41 41 16 41 41 41 2 2 2 2 2 2 1 2 2 2 2 2 2 18 1 2 2 2 2 2 2 1 2 2 2 2 1 2 2 2 2 2 2 2 2 2 2 2 1 2 2 2 2 2 2 1 2 7 
8 1 41 41 41 18 41 41 41 18 41 41 41 18 41 41 41 2 2 2 1 1 2 2 2 2 2 2 2 2 16 1 2 2 2 2 2 2 2 2 2 2 2 2 2 2 2 2 1 2 2 2 2 2 1 1 2 2 2 2 1 2 2 2 7 
8 1 41 41 41 16 41 41 41 16 41 41 41 16 41 41 41 2 2 2 2 2 2 2 2 1 2 1 2 2 18 2 2 2 2 1 1 1 2 2 2 2 2 2 2 2 2 2 1 2 2 1 1 1 2 2 2 1 2 1 2 2 2 1 7 
8 2 40 29 17 29 17 29 17 29 17 29 17 29 17 29 38 2 2 2 2 2 1 2 2 2 2 1 1 2 16 2 2 2 2 2 2 2 2 1 1 2 2 2 1 2 2 1 2 2 2 2 2 2 2 1 2 2 2 2 2 2 2 2 7 
8 2 2 2 1 1 1 1 2 2 2 2 1 2 2 2 2 1 1 2 2 1 1 2 2 2 2 2 2 2 18 2 2 2 2 2 2 2 2 2 2 2 2 1 2 2 2 2 2 2 2 2 2 2 2 2 2 2 2 2 2 1 2 1 7 
8 2 2 2 2 2 2 2 2 2 2 2 2 2 2 2 2 2 2 2 2 2 2 2 2 2 2 2 2 2 16 2 2 2 2 2 2 2 2 2 2 2 2 2 2 2 2 2 2 2 2 2 2 2 2 2 2 2 2 2 2 2 2 2 7 
8 2 2 2 2 2 2 2 2 2 2 2 2 2 2 2 2 2 2 1 2 2 2 2 2 2 1 2 2 2 18 2 2 2 2 2 2 2 1 2 2 2 2 2 2 2 2 2 2 2 2 2 2 2 2 2 2 1 2 2 2 2 2 2 7 
8 2 1 2 2 2 2 2 1 1 2 1 2 2 2 2 2 2 2 1 2 2 2 1 2 2 2 2 2 1 16 2 2 1 2 2 2 2 2 1 1 2 2 2 2 2 2 2 2 2 2 2 1 1 1 2 1 2 2 2 1 2 2 2 7 
8 2 1 2 2 2 2 2 2 2 2 2 2 1 2 2 2 2 2 1 2 2 1 2 2 2 2 2 1 2 18 2 2 2 1 2 2 2 2 2 2 2 2 1 1 2 2 2 2 2 2 2 2 2 2 1 2 2 2 1 2 2 2 2 7 
8 2 1 2 2 1 1 2 1 2 2 2 2 2 2 2 2 2 2 1 2 2 1 2 2 2 2 2 1 2 16 2 2 2 1 2 2 2 2 2 2 2 2 2 2 1 2 2 2 2 2 2 2 2 2 1 2 2 1 2 2 2 2 2 7 
8 2 1 2 2 2 2 2 1 2 2 2 1 2 2 2 2 2 2 2 2 1 2 2 2 2 1 2 2 2 18 2 2 2 2 2 2 2 1 1 2 2 2 2 2 2 2 2 2 2 2 2 1 1 1 2 2 2 2 2 2 2 2 2 7 
8 2 2 2 2 2 2 2 2 2 2 2 2 2 2 1 2 2 1 2 1 2 2 2 2 2 2 2 2 2 16 2 2 2 2 2 2 2 2 2 2 2 2 2 2 2 2 2 2 2 2 2 2 2 2 2 2 2 2 2 2 1 2 2 7 
8 2 2 1 2 1 2 2 2 2 2 2 2 2 2 2 2 2 2 2 2 2 2 2 1 2 2 2 2 2 18 2 2 2 2 1 1 2 2 2 2 2 2 2 2 2 2 2 2 2 2 2 2 1 2 1 2 2 2 2 2 2 2 2 7 
8 1 2 2 2 2 1 2 2 2 2 2 2 1 2 2 2 2 1 1 1 1 2 2 2 2 2 2 1 2 16 2 1 2 2 2 2 2 2 2 2 2 2 2 2 2 2 2 2 2 2 1 2 2 2 2 1 2 2 2 1 2 2 2 7 
8 2 2 1 2 2 2 1 2 2 2 2 1 2 2 2 2 2 2 2 2 2 2 2 2 2 1 2 2 2 18 2 2 2 2 2 2 2 2 2 2 1 2 1 1 2 2 2 2 2 2 2 2 2 2 2 2 2 2 1 2 2 2 2 7 
8 2 2 1 2 2 2 41 41 41 41 41 2 2 2 1 2 41 41 41 41 41 2 2 2 2 2 2 2 2 16 2 2 2 2 2 2 2 2 2 2 2 2 2 2 2 40 19 17 30 17 19 17 30 17 19 17 30 17 19 38 2 2 2 7 
8 2 2 2 1 2 1 41 41 41 41 41 2 2 2 1 2 41 41 41 41 41 2 2 2 2 2 2 2 2 18 2 2 2 1 2 2 2 2 2 1 1 2 2 2 2 41 41 41 16 41 41 41 16 41 41 41 16 41 41 41 2 1 2 7 
8 2 2 2 2 2 2 41 41 41 41 41 2 1 2 2 2 41 41 41 41 41 2 2 1 1 1 2 2 2 16 2 2 2 2 1 2 2 1 2 2 2 2 2 2 2 41 41 41 18 41 41 41 18 41 41 41 18 41 41 41 2 1 1 7 
8 2 1 2 2 2 2 2 2 18 2 2 2 2 2 2 2 2 2 18 2 2 2 2 2 2 2 2 2 2 20 2 2 2 2 1 1 2 2 2 2 2 2 2 2 2 41 41 41 16 41 41 41 16 41 41 41 16 41 41 41 2 2 1 7 
8 1 2 2 40 19 17 19 17 29 17 19 17 19 17 19 17 19 17 29 17 19 17 19 17 19 17 19 17 25 31 26 17 19 17 19 17 19 17 19 17 19 17 19 17 19 17 29 17 31 17 29 17 31 17 29 17 31 17 29 38 1 2 2 7 
8 2 2 2 2 2 2 1 2 2 2 2 2 2 2 2 2 2 2 2 2 1 2 2 2 2 2 2 2 2 24 2 2 2 2 2 2 2 2 2 2 2 2 2 2 2 41 41 41 16 41 41 41 16 41 41 41 16 41 41 41 1 2 2 7 
8 1 2 1 2 2 2 1 2 2 2 2 1 2 1 1 2 2 2 2 2 2 1 2 2 2 2 2 2 1 16 2 2 1 1 1 1 2 2 2 2 1 1 2 2 2 41 41 41 18 41 41 41 18 41 41 41 18 41 41 41 2 2 2 7 
8 2 2 2 2 2 2 2 2 2 2 2 2 2 2 2 2 2 2 2 2 2 2 2 2 2 2 2 2 2 18 2 2 2 2 2 2 2 2 2 2 2 2 2 2 2 41 41 41 16 41 41 41 16 41 41 41 16 41 41 41 1 1 2 7 
8 2 2 2 2 1 1 2 2 2 2 2 1 2 2 2 2 2 2 2 2 2 2 2 1 2 2 2 1 2 16 2 2 2 2 2 2 1 2 2 2 2 2 2 1 2 40 29 17 31 17 29 17 31 17 29 17 31 17 29 38 1 2 2 7 
8 2 2 1 2 2 2 1 1 2 2 2 2 2 2 2 2 2 2 1 2 2 2 2 1 2 2 2 1 2 18 2 2 1 2 2 2 2 2 2 2 2 1 2 1 2 41 41 41 16 41 41 41 16 41 41 41 16 41 41 41 1 1 2 7 
8 2 2 1 1 2 2 2 1 2 2 1 2 2 2 2 2 2 2 2 2 1 2 2 1 2 2 1 2 2 16 2 2 1 2 2 1 2 2 2 2 1 2 2 2 2 41 41 41 18 41 41 41 18 41 41 41 18 41 41 41 2 1 1 7 
8 2 2 2 2 2 2 2 2 2 2 1 2 2 2 2 2 2 2 2 2 2 2 2 2 2 2 2 2 2 18 2 2 2 2 2 1 2 2 2 2 1 2 2 2 2 41 41 41 16 41 41 41 16 41 41 41 16 41 41 41 1 1 1 7 
8 2 2 2 2 2 2 2 2 2 2 2 2 2 2 1 2 2 2 2 2 2 2 2 2 2 2 2 2 2 16 2 2 2 2 2 2 2 2 2 2 2 2 2 2 2 40 29 17 29 17 29 17 29 17 29 17 29 17 29 38 1 2 2 7 
8 2 1 1 2 2 2 2 2 2 1 2 2 2 2 2 2 2 2 1 2 1 1 2 2 2 2 2 2 1 18 2 2 1 1 2 2 2 2 2 2 1 2 2 2 1 2 2 2 2 2 2 2 1 2 2 2 2 2 2 2 2 2 2 7 
8 2 2 2 2 1 1 2 2 2 1 2 2 2 1 2 2 2 2 2 1 2 1 2 2 2 2 2 1 2 16 2 2 2 2 2 1 2 2 2 2 2 1 2 2 2 1 2 2 1 2 2 2 2 2 1 2 2 1 1 2 2 2 2 7 
8 2 1 2 2 2 1 2 2 2 2 1 2 2 2 2 2 2 1 2 2 2 2 2 2 2 1 2 2 2 18 2 2 2 2 1 2 2 2 2 2 2 2 2 2 2 2 2 2 2 2 2 2 2 2 2 2 1 2 2 2 2 2 2 7 
8 2 2 2 2 2 2 1 2 1 2 2 2 2 2 1 2 2 2 2 1 2 2 2 1 2 1 1 2 36 36 36 2 2 1 2 1 1 2 1 1 2 1 2 2 1 2 2 1 2 2 2 2 2 1 2 2 1 2 2 2 2 2 2 7 
8 2 1 2 2 2 2 1 2 1 2 2 2 2 2 1 2 2 2 2 2 2 1 2 2 2 2 2 2 2 2 2 2 2 1 2 2 2 2 2 2 2 2 1 2 2 2 1 2 2 2 1 1 2 2 2 2 2 2 1 2 2 1 2 7 
8 2 1 2 2 1 1 1 2 1 2 2 1 2 1 2 2 2 2 1 2 1 2 2 4 5 5 5 5 5 5 5 5 5 5 5 6 2 1 2 2 1 1 2 1 1 2 2 2 2 1 2 2 2 2 2 1 2 2 2 2 2 2 1 7 
8 2 2 2 1 2 2 2 2 2 2 2 1 2 1 2 2 2 1 2 2 2 2 2 7 3 3 3 3 3 3 3 3 3 3 3 8 2 1 2 2 2 2 2 2 2 2 2 2 2 2 1 2 2 2 2 2 2 2 2 1 1 2 2 7 
8 2 2 2 1 2 2 2 2 2 2 2 1 2 1 2 2 2 1 2 2 2 2 2 7 3 3 3 3 3 3 3 3 3 3 3 8 2 1 2 2 2 2 2 2 2 2 2 2 2 2 1 2 2 2 2 2 2 2 2 1 1 2 2 7 
14 5 5 5 5 5 5 5 5 5 5 5 5 5 5 5 5 5 5 5 5 5 5 5 15 3 3 3 3 3 3 3 3 3 3 3 14 5 5 5 5 5 5 5 5 5 5 5 5 5 5 5 5 5 5 5 5 5 5 5 5 5 5 5 15 
